WORD,N,V,ART,P,TOTAL
flies,21,23,0,0,44
fruit,49,5,1,0,55
like,10,30,0,21,61
a,1,0,201,0,202
the,1,0,300,2,303
flower,53,15,0,0,68
flowers,42,16,0,0,58
birds,64,1,0,0,65
others,592,210,56,284,1142
TOTAL,833,300,558,307,1998